### WHITELIST DOMAINS ###
1.168.192.in-addr.arpa	Chris-White
screenshot3.bid	EasyList-White
abuse.ch	Chris-White
ice.infomaniak.ch	Chris-White
blocklist.greensnow.co	Chris-White
cdn-icloud-content.g.aaplimg.com	Chris-White
abc.com	Chris-White
abcnews.com	Chris-White
adguard.com	Chris-White
admuncher.com	Chris-White
amazon.com	Chris-White
s3.amazonaws.com	Chris-White
americanexpress.com	Chris-White
ampproject.com	Chris-White
android.com	Chris-White
anveo.com	Chris-White
apc.com	Chris-White
apcc.com	Chris-White
apple.com	Chris-White
babasbrew.com	Chris-White
bac-assets.com	Chris-White
badips.com	Chris-White
bankofamerica.com	Chris-White
binarydefense.com	Chris-White
homebrew.bintray.com	Chris-White
bofaml.com	Chris-White
adserver.bworldonline.com	EasyList-White
careerbuilder.com	Chris-White
media.cargocollective.com	EasyList-White
cdn-apple.com	Chris-White
cdninstagram.com	Chris-White
cheezburger.com	Chris-White
cbuprovidence.chickenkiller.com	Chris-White
chrisbuijs.com	Chris-White
chzbgr.com	Chris-White
cinsscore.com	Chris-White
cnbc.com	Chris-White
cnet.com	Chris-White
webtrack.dhlglobalmail.com	EasyPrivacy-White
cbuhome.dnsalias.com	Chris-White
dropbox.com	Chris-White
dropboxapi.com	Chris-White
dropboxstatic.com	Chris-White
dropboxusercontent.com	Chris-White
dslreports.com	Chris-White
dyn.com	Chris-White
e2ro.com	Chris-White
eero.com	Chris-White
evite.com	Chris-White
expedia.com	Chris-White
fitbit.com	Chris-White
fsecurify.com	Chris-White
fuelrewards.com	Chris-White
funniermoments.com	EasyList-White
ggpht.com	Chris-White
github.com	Chris-White
githubapp.com	Chris-White
githubusercontent.com	Chris-White
gmail.com	Chris-White
go.com	Chris-White
googlecode.com	Chris-White
googleusercontent.com	Chris-White
connectivitycheck.gstatic.com	Chris-White
play-music.gstatic.com	Chris-White
hubspot.com	Chris-White
icloud.com	Chris-White
icloud-content.com	Chris-White
ifttt.com	Chris-White
igcdn.com	Chris-White
videosxml.mobileads.indiatimes.com	EasyList-White
instagram.com	Chris-White
intuit.com	Chris-White
invensys.com	Chris-White
lastpass.com	Chris-White
licdn.com	Chris-White
linkedin.com	Chris-White
officeapps.live.com	Chris-White
malwaredomainlist.com	Chris-White
malwaredomains.com	Chris-White
avts.mcafee.com	Chris-White
media-amazon.com	Chris-White
merrilledge.com	Chris-White
messagelabs.com	Chris-White
officecdn.microsoft.com	Chris-White
msftconnecttest.com	Chris-White
msnbc.com	Chris-White
mzstatic.com	Chris-White
nbcnews.com	Chris-White
nbcuas.com	Chris-White
nbcuni.com	Chris-White
nbcuniversal.com	Chris-White
nespresso.com	Chris-White
nest.com	Chris-White
netflix.com	Chris-White
netgear.com	Chris-White
nflxext.com	Chris-White
office365.com	Chris-White
schneiderelectric.mail.onmicrosoft.com	Chris-White
opendns.com	Chris-White
openphish.com	Chris-White
outlook.com	Chris-White
peapod.com	Chris-White
pelco.com	Chris-White
nytimes.perfectmarket.com	EasyList-White
query.petametrics.com	EasyPrivacy-White
data.phishtank.com	Chris-White
providencejournal.com	Chris-White
track2.royalmail.com	EasyPrivacy-White
s-nbcnews.com	Chris-White
dove.saymedia.com	EasyList-White
schneider-electric.com	Chris-White
api-merchants.skimlinks.com	EasyList-White
authentication-api.skimlinks.com	EasyList-White
skype.com	Chris-White
slack.com	Chris-White
static.reverse.softlayer.com	Chris-White
sonos.com	Chris-White
spotify.com	Chris-White
squarespace.com	Chris-White
ssl-images-amazon.com	Chris-White
stopandshop.com	Chris-White
stopforumspam.com	Chris-White
player.sundaysky.com	EasyPrivacy-White
tac.com	Chris-White
talosintel.com	Chris-White
oas.theguardian.com	EasyList-White
tomtom.com	Chris-White
img.travidia.com	EasyList-White
tunein.com	Chris-White
adserver.tvcatchup.com	EasyList-White
adverts.cdn.tvcatchup.com	EasyList-White
urlblacklist.com	Chris-White
schneider-electric.webex.com	Chris-White
wellsfargo.com	Chris-White
wellsfargoadvisors.com	Chris-White
wellsfargomedia.com	Chris-White
whatsapp.com	Chris-White
windowsupdate.com	Chris-White
banners.wunderground.com	EasyList-White
wyzecam.com	Chris-White
xda-cdn.com	Chris-White
xda-developers.com	Chris-White
youtube-nocookie.com	Chris-White
turris.cz	Chris-White
blocklist.de	Chris-White
shallalist.de	Chris-White
mirror.cedia.org.ec	Chris-White
sans.edu	Chris-White
botvrij.eu	Chris-White
free.fr	Chris-White
lepoint.fr	Chris-White
ut-capitole.fr	Chris-White
goo.gl	Chris-White
goog	Chris-White
void.gr	Chris-White
lnkd.in	Chris-White
dnscrypt.info	Chris-White
dnsdb.info	Chris-White
advertising.oriel.io	EasyList-White
sbc.io	Chris-White
suspect-networks.io	Chris-White
adblock.mahakala.is	Chris-White
margevicius.lt	Chris-White
ssl.bblck.me	Chris-White
afrinic.net	Chris-White
apple-support.akadns.net	Chris-White
apple.com.akadns.net	Chris-White
blobstore-apple.com.akadns.net	Chris-White
cdn-apple.com.akadns.net	Chris-White
gc-apple.com.akadns.net	Chris-White
icloud.com.akadns.net	Chris-White
itunes-apple.com.akadns.net	Chris-White
apple.com.edgekey.net.globalredir.akadns.net	Chris-White
sonos.com.edgekey.net.globalredir.akadns.net	Chris-White
apnic.net	Chris-White
apple-dns.net	Chris-White
arin.net	Chris-White
bro-tracker.atlassian.net	Chris-White
maps.chitika.net	EasyList-White
maps-static.chitika.net	EasyList-White
fitbit.com.cdn.cloudflare.net	Chris-White
d2qxwxxauf5yxr.cloudfront.net	Chris-White
d3jdtixm7cvu7y.cloudfront.net	Chris-White
darksky.net	Chris-White
dropbox.net	Chris-White
p13.dynect.net	Chris-White
apple.com.edgekey.net	Chris-White
icloud.com.edgekey.net	Chris-White
sonos.com.edgekey.net	Chris-White
emergingthreats.net	Chris-White
v.firebog.net	Chris-White
chzbgr.com.c.footprint.net	Chris-White
adblock.gardar.net	Chris-White
gtld-servers.net	Chris-White
hosts-file.net	Chris-White
intuitcdn.net	Chris-White
ituneslogin.net	Chris-White
lacnic.net	Chris-White
netflix.net	Chris-White
nflximg.net	Chris-White
nflxvideo.net	Chris-White
nbcume.sc.omtrdc.net	Chris-White
bankofamerica.tt.omtrdc.net	Chris-White
ripe.net	Chris-White
root-servers.net	Chris-White
taleo.net	Chris-White
wget-mirrors.uceprotect.net	Chris-White
whatsapp.net	Chris-White
xpanama.net	EasyList-White
ad.nl	Chris-White
internet.nl	Chris-White
ads.memo2.nl	EasyList-White
reaal.nl	Chris-White
hostsfile.mine.nu	Chris-White
fanboy.co.nz	Chris-White
advertising.scoop.co.nz	EasyList-White
easylist-downloads.adblockplus.org	Chris-White
adtidy.org	Chris-White
ampproject.org	Chris-White
antipubfirefox.org	Chris-White
logging.apache.org	EasyPrivacy-White
tracker.bro.org	Chris-White
debian.org	Chris-White
download.dnscrypt.org	Chris-White
dshield.org	Chris-White
dyndns.org	Chris-White
iana.org	Chris-White
isc.org	Chris-White
lede-project.org	Chris-White
lineageos.org	Chris-White
winhelp2002.mvps.org	Chris-White
networksec.org	Chris-White
notabug.org	Chris-White
nothink.org	Chris-White
ntp.org	Chris-Exclude
pelco.org	Chris-White
projecthoneypot.org	Chris-White
sans.org	Chris-White
schema.org	Chris-White
someonewhocares.org	Chris-White
spamhaus.org	Chris-White
squidblacklist.org	Chris-White
stanev.org	Chris-White
sysctl.org	Chris-White
team-cymru.org	Chris-White
check.torproject.org	Chris-White
metrics.torproject.org	EasyPrivacy-White
widscambridge.org	Chris-White
yoyo.org	Chris-White
tvn.adocean.pl	EasyList-White
gotcha.pw	Chris-White
zoso.ro	Chris-White
banners.gametracker.rs	EasyList-White
danger.rulez.sk	Chris-White
easylist.to	Chris-White
france.tv	Chris-White
squidguard.mesd.k12.or.us	Chris-White
hosts.ubuntu101.co.za	Chris-White
### WHITELIST IPv4 ###
1.0.0.1/32	Chris-White
1.1.1.1/32	Chris-White
8.8.4.4/32	Chris-White
8.8.8.8/32	Chris-White
9.9.9.9/32	Chris-White
149.112.112.112/32	Chris-White
176.103.130.130/31	Aggregated
176.103.130.132/32	Chris-White
176.103.130.134/32	Chris-White
192.30.253.112/31	Chris-White
192.168.1.0/24	Chris-White
192.168.100.0/25	Chris-White
213.230.210.230/32	Chris-White
### WHITELIST IPv6 ###
### WHITELIST EOF ###
